14,14
400,400,400,400,400,200,115,104,104,0,0,0,0,200
400,400,400,400,200,104,115,104,104,0,0,104,115,200
400,400,400,0,1,104,104,115,104,115,104,104,0,200
400,400,0,1,300,115,104,115,104,104,104,104,104,200
400,0,104,300,104,104,104,104,104,200,0,1,104,200
0,0,115,300,103,114,111,0,200,200,1,115,0,500
0,0,1,111,0,114,103,0,200,114,104,115,0,500
0,1,300,300,0,103,111,104,104,104,104,115,500,500
0,0,300,0,104,114,114,114,104,104,0,300,500,500
0,114,300,104,115,104,114,115,104,104,1,300,500,400
0,103,115,104,115,114,104,104,104,104,200,200,400,400
200,104,0,104,104,0,104,115,104,1,200,400,400,400
200,0,0,0,0,115,104,104,115,200,400,400,400,400
200,200,0,104,0,0,104,104,104,400,400,400,400,400
6
12,6,0,60,20,0,20,20,0,0,2,Archer
11,8,0,60,20,0,20,20,1,1,1,Archer
12,5,0,100,30,0,25,10,0,0,2,Cavalry
11,6,0,80,30,0,20,20,0,0,2,Swordsman
10,8,0,80,30,0,20,20,1,1,1,Swordsman
10,9,0,100,30,0,25,10,1,1,1,Cavalry
10
2,6
3,5
3,6
3,7
2,7
2,8
3,8
1,8
1,7
1,6
