29,25
400,400,400,400,400,400,400,400,113,113,600,600,600,600,500,500,500,600,600,600,600,600,600,600,600
400,400,400,400,400,400,400,113,113,600,113,600,600,600,500,500,500,600,600,600,600,600,600,600,600
400,400,400,400,400,400,113,113,113,600,600,600,600,600,500,500,600,600,600,600,600,600,600,600,600
400,400,400,400,400,113,113,113,113,600,600,113,600,500,500,500,600,600,600,600,600,600,600,600,600
400,400,400,400,113,113,113,113,600,600,600,600,600,500,500,500,600,600,600,600,600,600,600,600,600
400,400,400,113,113,113,113,113,600,113,600,600,600,600,600,600,600,600,600,600,600,600,600,600,600
400,400,113,113,113,113,113,600,600,113,600,600,600,600,600,600,600,600,600,600,600,600,600,600,600
400,113,113,113,600,600,600,600,600,600,600,600,600,600,500,500,600,600,600,600,600,600,600,600,600
113,113,113,600,600,600,600,600,600,600,600,600,600,500,500,500,600,600,600,600,600,600,600,600,600
113,113,600,600,113,113,600,600,600,600,600,600,600,500,500,500,600,600,600,600,600,600,600,600,600
113,113,600,600,600,600,600,600,600,600,600,600,600,500,500,500,500,600,600,500,500,500,500,500,500
113,113,600,600,600,600,113,600,600,600,600,600,0,500,500,500,500,500,500,500,500,500,500,500,500
113,600,600,600,600,600,113,600,600,600,600,0,0,0,500,500,500,500,500,500,500,500,500,500,500
600,600,600,600,600,600,600,600,600,0,0,0,0,0,500,500,500,500,500,600,600,600,600,600,600
600,600,600,600,600,600,600,600,0,0,0,0,0,500,500,500,500,600,600,600,600,600,114,114,114
600,113,600,600,600,600,600,600,0,0,0,500,500,500,500,600,600,600,600,600,600,600,114,114,114
600,600,600,600,600,600,600,600,0,0,500,500,500,500,600,600,600,600,600,600,600,600,114,114,201
600,600,600,600,600,600,600,600,500,500,500,500,500,600,600,600,600,114,600,600,600,114,114,201,201
600,600,600,600,600,600,600,500,500,500,500,600,600,600,600,600,600,600,600,600,114,114,201,201,201
600,600,600,600,600,600,500,500,500,500,600,600,600,600,600,600,600,600,600,600,114,114,201,201,201
600,600,600,600,600,500,500,500,500,600,600,600,600,600,600,600,114,600,600,600,114,114,201,201,400
600,600,600,600,500,500,500,601,600,600,600,600,600,600,600,600,600,600,114,114,114,114,201,400,400
600,600,600,500,500,500,601,600,600,600,600,600,600,600,600,600,600,600,114,114,201,201,400,400,400
600,600,600,600,600,600,601,600,600,600,600,600,600,600,600,600,114,114,114,201,201,400,400,400,400
600,600,600,600,600,600,600,600,600,600,600,600,114,600,600,114,114,201,201,201,400,400,400,400,400
600,500,500,500,600,600,600,600,600,600,600,600,600,600,114,114,201,201,201,400,400,400,400,400,400
600,500,500,500,600,600,600,600,600,600,114,600,600,114,114,201,201,200,400,400,400,400,400,400,400
500,500,500,600,600,600,600,600,600,600,600,600,114,114,201,200,200,400,400,400,400,400,400,400,400
500,500,500,600,600,600,600,600,600,600,600,114,114,200,200,200,400,400,400,400,400,400,400,400,400
24
21,16,0,60,20,0,20,20,-1,-1,0,Archer
22,16,0,60,20,0,20,20,-1,-1,0,Archer
23,15,0,60,20,0,20,20,-1,-1,0,Archer
24,14,0,60,20,0,20,20,-1,-1,0,Archer
25,14,0,60,20,0,20,20,-1,-1,0,Archer
24,15,0,60,20,0,20,20,-1,-1,0,Archer
20,16,0,60,20,0,20,20,-1,-1,0,Archer
22,15,0,60,20,0,20,20,-1,-1,0,Archer
21,15,0,60,20,0,20,20,-1,-1,0,Archer
4,21,2,169,51,5,51,17,0,1,3,Cavalry
5,21,0,60,0,35,5,25,0,1,3,Mage
3,21,0,60,0,35,5,25,0,1,3,Mage
5,20,0,60,20,0,20,20,0,1,3,Archer
4,20,0,60,20,0,20,20,0,1,3,Archer
22,14,0,80,25,0,30,20,-1,-1,3,Swordsman
23,14,0,80,25,0,30,20,-1,-1,0,Swordsman
24,13,0,80,25,0,30,20,-1,-1,0,Swordsman
26,13,0,80,25,0,30,20,-1,-1,0,Swordsman
25,13,0,80,25,0,30,20,-1,-1,0,Swordsman
26,12,0,80,25,0,30,20,-1,-1,3,Swordsman
25,12,0,80,25,0,30,20,-1,-1,3,Swordsman
24,12,0,80,25,0,30,20,-1,-1,3,Swordsman
23,13,0,80,25,0,30,20,-1,-1,0,Swordsman
22,13,0,80,25,0,30,20,-1,-1,3,Swordsman
0
