0
17,16
200,200,200,200,200,200,200,200,200,200,200,200,200,200,200,200
200,200,200,200,200,200,200,200,200,104,104,0,0,0,200,200
200,111,111,0,0,0,114,114,114,104,111,111,0,0,0,200
118,112,112,118,111,111,111,111,111,111,118,111,111,111,0,200
112,112,112,111,0,201,201,0,0,111,0,0,0,118,104,201
112,112,112,0,200,201,201,200,0,200,200,200,200,118,104,201
112,111,111,200,200,200,201,200,200,200,201,200,0,111,104,201
200,104,111,104,0,200,200,200,201,201,201,200,0,111,104,200
200,104,111,104,0,0,200,200,201,201,200,0,111,104,0,200
200,0,111,111,0,0,200,200,201,200,200,104,111,104,200,200
200,0,0,111,111,0,200,200,200,200,104,104,118,104,200,201
200,0,0,111,0,200,200,200,104,104,104,111,104,104,201,201
200,0,111,118,0,0,104,104,104,111,104,111,104,104,200,201
201,0,111,111,111,118,111,111,118,111,111,111,104,104,201,201
201,0,0,0,111,118,111,0,0,0,111,111,104,0,201,200
201,0,0,0,0,0,0,200,0,0,111,112,112,0,200,200
200,200,200,200,200,200,200,200,200,0,114,112,112,0,200,0
12
11,8,0,60,20,0,20,20,0,0,0,Archer
12,8,0,80,25,0,30,20,0,0,0,Swordsman
12,9,0,80,25,0,30,20,0,0,0,Swordsman
9,2,0,80,25,0,30,20,0,0,0,Swordsman
9,3,0,80,25,0,30,20,0,0,0,Swordsman
8,3,0,60,0,35,5,25,0,0,0,Mage
6,13,0,60,0,35,5,25,0,0,0,Mage
3,6,0,60,20,0,20,20,0,0,0,Archer
2,7,0,80,25,0,30,20,0,0,0,Swordsman
3,7,0,80,25,0,30,20,0,0,0,Swordsman
5,13,0,80,25,0,30,20,0,0,0,Swordsman
5,14,0,80,25,0,30,20,0,0,0,Swordsman
8
12,3
13,2
13,3
13,4
2,11
3,11
3,12
3,13
