12,16
0,0,0,0,0,0,0,0,0,400,0,0,0,0,0,0
0,0,0,0,0,0,0,0,400,400,0,0,0,0,0,0
0,0,0,0,0,0,0,0,400,400,0,0,0,0,0,0
0,0,0,0,0,0,0,400,400,0,0,0,0,0,0,0
0,0,0,0,0,0,0,400,0,0,0,0,0,0,0,0
0,0,0,0,0,0,400,400,0,0,0,0,0,0,0,0
0,0,0,0,0,0,400,400,0,0,0,0,0,0,0,0
0,0,0,0,0,400,400,0,0,0,0,0,0,0,0,0
0,0,0,0,0,400,0,0,0,0,0,0,0,0,0,0
0,0,0,0,400,400,0,0,0,0,0,0,0,0,0,0
0,0,0,0,400,400,0,0,0,0,0,0,0,0,0,0
0,0,0,0,400,0,0,0,0,0,0,0,0,0,0,0
0
0
