18,20
3,3,3,3,102,400,400,400,400,400,400,400,400,400,400,400,400,102,3,3
3,3,3,102,400,400,400,400,400,400,400,400,400,400,400,400,400,102,3,3
3,3,3,102,400,400,400,400,400,400,400,400,400,400,400,400,105,102,102,102
3,3,102,102,105,105,400,400,400,400,105,400,400,400,400,105,105,400,400,102
3,102,102,105,105,105,105,105,400,400,105,105,400,105,105,105,400,400,400,400
102,400,400,400,400,105,105,105,105,105,107,105,105,107,105,400,400,400,400,400
400,400,400,400,400,400,400,105,105,105,107,107,107,107,105,400,400,400,400,400
400,400,400,400,400,400,400,400,400,105,107,107,107,105,400,400,400,400,400,400
400,400,400,400,400,400,400,400,105,107,107,107,107,105,400,400,400,400,400,400
400,400,400,400,400,400,400,400,105,107,107,107,105,400,400,400,400,400,400,400
400,400,400,400,400,400,400,105,105,105,500,500,105,105,105,400,400,400,400,400
400,400,400,400,400,400,105,105,500,500,500,500,500,105,105,105,400,400,400,102
400,400,400,400,400,105,105,500,500,500,501,500,500,105,105,105,105,105,102,3
400,102,102,400,105,105,500,500,501,501,501,501,500,500,105,105,105,102,102,3
102,3,102,102,102,500,500,501,501,501,501,501,500,500,500,500,102,102,3,3
3,102,3,102,102,500,501,501,501,501,501,501,501,500,500,500,102,102,3,3
3,3,3,3,102,501,501,502,502,502,502,501,501,501,501,102,102,3,3,3
3,3,3,102,501,501,502,502,502,502,502,502,501,501,102,102,102,3,3,3
12
11,6,0,80,25,0,30,-20,3,6,7,1,1,Swordsman
12,6,0,80,25,0,30,-20,3,6,7,1,1,Swordsman
5,7,0,80,25,0,30,-20,3,6,7,1,0,Swordsman
4,7,0,80,25,0,30,-20,3,6,7,1,0,Swordsman
2,16,0,80,25,0,30,-20,3,6,7,1,4,Swordsman
3,16,0,80,25,0,30,-20,3,6,7,1,4,Swordsman
10,13,0,80,25,0,30,-20,3,6,7,1,2,Swordsman
2,2,0,80,25,0,30,-20,3,6,7,1,0,Swordsman
3,1,0,80,25,0,30,-20,3,6,7,1,0,Swordsman
15,2,0,80,25,0,30,-20,3,6,7,1,1,Swordsman
13,17,0,80,25,0,30,-20,3,6,7,1,2,Swordsman
14,16,0,80,25,0,30,-20,3,6,7,1,2,Swordsman
8
7,11
6,11
6,12
7,12
8,11
8,10
7,10
9,10
