18,20
3,3,3,3,102,302,300,300,300,300,300,300,300,300,300,300,302,102,3,3
3,3,3,102,302,300,300,300,300,300,300,300,300,300,300,300,302,102,3,3
3,3,3,102,302,302,302,300,300,300,302,302,302,300,300,302,105,102,102,102
3,3,102,102,105,105,302,302,302,302,105,302,302,302,302,105,105,302,302,102
3,102,102,105,105,105,105,105,302,302,105,105,302,105,105,105,302,302,302,302
102,302,302,302,302,105,105,105,105,105,107,105,105,107,105,302,302,300,300,300
302,300,300,302,302,302,302,105,105,105,107,107,107,107,105,302,300,301,301,301
300,301,300,300,300,300,302,302,302,105,107,107,107,105,302,302,300,301,301,301
301,301,301,301,301,300,300,302,105,107,107,107,107,105,302,300,300,300,301,300
301,301,301,301,301,300,300,302,105,107,107,107,105,302,302,302,300,300,300,300
301,301,301,301,300,300,302,105,105,105,105,105,105,105,105,302,302,300,300,302
301,300,300,300,300,302,105,105,302,302,302,302,302,105,105,105,302,302,302,102
300,302,302,302,302,105,105,302,300,300,300,300,302,105,105,105,105,105,102,3
300,102,102,302,105,105,302,300,301,301,300,300,302,302,105,105,105,102,102,3
102,3,102,102,102,302,302,300,301,301,300,300,302,302,302,302,102,102,3,3
3,102,3,102,102,302,300,301,301,301,300,300,300,300,300,302,102,102,3,3
3,3,3,3,102,302,300,301,301,301,301,301,301,300,302,102,102,3,3,3
3,3,3,102,302,300,301,301,301,301,301,301,300,302,102,102,102,3,3,3
12
11,6,0,80,25,0,30,0,3,6,7,1,1,Swordsman
12,6,0,80,25,0,30,0,3,6,7,1,1,Swordsman
5,7,0,80,25,0,30,0,3,6,7,1,0,Swordsman
4,7,0,80,25,0,30,0,3,6,7,1,0,Swordsman
2,16,0,80,25,0,30,0,3,6,7,1,4,Swordsman
3,16,0,80,25,0,30,0,3,6,7,1,4,Swordsman
10,13,0,80,25,0,30,0,3,6,7,1,2,Swordsman
2,2,0,80,25,0,30,0,3,6,7,1,0,Swordsman
3,1,0,80,25,0,30,0,3,6,7,1,0,Swordsman
15,2,0,80,25,0,30,0,3,6,7,1,1,Swordsman
13,17,0,80,25,0,30,0,3,6,7,1,2,Swordsman
14,16,0,80,25,0,30,0,3,6,7,1,2,Swordsman
8
7,11
6,11
6,12
7,12
8,11
8,10
7,10
9,10
