13,12
200,201,201,200,201,200,200,201,200,200,200,200
201,201,200,201,200,6,7,6,7,201,200,201
201,200,7,6,6,6,6,6,115,104,200,200
200,200,6,6,7,7,6,104,115,104,115,200
201,6,7,7,7,6,7,7,103,111,103,111
200,6,7,7,7,6,104,104,111,111,112,112
201,6,7,6,6,104,104,103,103,113,108,107
200,7,6,104,115,115,111,111,112,108,302,302
200,6,104,104,104,104,111,113,107,302,300,300
201,7,115,104,103,111,112,108,302,302,300,301
200,200,104,111,103,113,107,302,300,300,301,301
200,200,103,111,111,112,108,302,300,301,301,301
200,200,111,111,113,108,302,300,301,301,301,301
0
0
