14,14
400,400,400,400,400,200,104,104,104,0,0,0,0,200
400,400,400,400,200,104,104,104,104,0,0,104,104,200
400,400,400,0,1,104,104,104,104,104,104,104,0,200
400,400,0,1,104,104,104,104,104,104,104,104,104,200
400,0,104,1,104,104,104,104,104,200,0,1,104,200
0,0,104,104,100,114,103,0,200,200,1,104,0,500
0,0,1,103,0,114,103,0,200,114,104,104,0,500
0,1,300,300,0,103,103,104,104,104,104,104,500,500
0,0,300,0,104,114,114,114,104,104,0,300,500,500
0,114,300,104,104,104,114,114,104,104,1,300,500,400
0,103,104,104,104,114,104,104,104,104,200,200,400,400
200,104,0,104,104,0,104,104,104,1,200,400,400,400
200,0,0,0,0,104,104,104,104,200,400,400,400,400
200,200,0,104,0,0,104,104,104,400,400,400,400,400
0
8
1,5
0,6
1,6
0,7
2,4
1,7
0,8
2,5
