0
26,27
104,104,104,104,104,104,104,104,104,104,104,104,104,104,104,104,104,7,7,6,6,6,7,6,7,6,7
104,104,103,103,103,104,103,103,104,103,103,103,103,103,104,104,103,103,103,103,103,103,103,103,103,103,103
103,103,102,102,103,103,102,103,103,102,103,103,103,103,103,103,103,103,103,103,103,103,103,103,103,103,103
102,102,102,102,102,102,102,102,102,103,104,104,104,104,103,103,6,7,7,7,7,6,103,103,103,103,103
102,102,102,102,102,102,103,103,103,104,200,202,104,103,104,104,202,202,201,202,200,6,103,103,103,7,7
102,102,102,102,103,103,104,104,104,201,200,104,103,104,104,200,201,200,200,200,201,6,103,103,200,202,7
102,102,103,103,104,104,104,200,201,201,104,103,104,202,200,201,200,7,7,7,6,103,103,103,201,200,201
102,103,104,104,200,201,201,200,104,104,103,104,201,201,200,202,7,6,7,104,104,103,103,6,7,7,200
103,104,200,200,201,200,104,104,103,103,104,202,201,202,104,104,103,103,103,103,103,103,103,103,6,7,200
104,200,201,104,104,104,103,103,103,104,202,202,200,104,103,103,102,102,103,103,103,103,103,7,7,7,200
202,201,104,104,103,103,103,104,104,200,200,104,104,103,102,102,102,103,6,7,7,7,6,7,7,7,201
200,104,103,103,102,103,104,202,201,201,104,104,103,102,102,102,103,6,200,202,200,202,7,7,7,7,202
104,103,102,102,103,104,200,200,201,202,104,103,103,103,102,103,104,200,200,201,201,200,6,7,7,7,7
103,102,102,103,104,104,200,200,200,104,103,103,104,103,102,103,104,202,201,200,200,202,7,7,7,7,7
102,102,103,104,104,201,201,202,104,103,103,200,104,103,103,104,202,201,200,501,201,201,6,7,7,7,7
103,103,104,202,201,202,104,104,103,103,104,200,104,103,104,200,201,201,501,501,201,202,7,7,7,7,7
104,104,104,200,201,104,104,103,103,104,200,104,103,103,104,200,201,501,501,501,201,201,6,7,7,7,7
202,200,201,200,104,103,103,103,104,200,202,104,103,103,104,201,201,501,501,501,201,200,7,7,7,7,7
200,201,200,104,103,102,103,104,200,200,104,103,103,104,202,201,501,501,501,501,200,7,7,7,7,7,7
201,202,104,103,102,102,103,104,200,104,103,102,103,104,202,201,501,502,501,501,200,7,7,7,7,7,7
200,104,104,103,102,103,104,200,202,104,103,103,104,200,201,501,501,502,501,501,500,500,7,7,7,7,7
202,104,103,102,103,104,200,200,104,103,102,103,104,201,201,501,502,502,501,501,500,500,500,7,7,7,7
104,103,102,102,103,104,200,200,104,103,103,104,202,201,501,501,502,502,501,501,500,500,500,7,7,6,7
104,103,102,103,104,202,200,202,104,103,103,104,200,201,501,501,502,502,501,501,501,500,7,7,7,6,6
103,102,103,104,200,200,200,104,103,103,104,202,200,501,501,502,502,502,501,501,501,500,7,7,7,7,7
102,103,104,202,200,200,202,104,103,104,202,200,501,501,502,502,502,502,502,501,501,500,7,7,7,7,7
19
1,10,1,78,0,46,7,33,0,0,0,Mage
2,10,1,78,0,46,7,33,0,0,0,Mage
1,15,0,60,0,35,5,25,0,0,0,Mage
7,9,1,104,39,0,39,26,0,0,0,Swordsman
8,9,0,80,25,0,30,20,0,0,0,Swordsman
2,15,1,104,39,0,39,26,0,0,0,Swordsman
3,15,1,104,39,0,39,26,0,0,0,Swordsman
14,9,0,100,30,0,30,10,0,0,0,Cavalry
15,9,0,100,30,0,30,10,0,0,0,Cavalry
16,12,0,60,20,0,20,20,0,0,0,Archer
16,13,0,60,20,0,20,20,0,0,0,Archer
9,15,0,100,30,0,30,10,0,0,0,Cavalry
9,16,0,100,30,0,30,10,0,0,0,Cavalry
10,15,0,60,20,0,20,20,0,0,0,Archer
2,23,0,60,20,0,20,20,0,0,0,Archer
3,24,0,80,80,0,5,5,0,0,0,Catapult
3,23,0,100,30,0,30,10,0,0,0,Cavalry
5,23,0,100,30,0,30,10,0,0,0,Cavalry
4,23,0,80,25,0,30,20,0,0,0,Swordsman
8
22,2
23,2
24,8
24,9
14,1
13,1
2,7
3,6
