0
28,23
203,203,203,203,203,203,203,203,203,203,203,203,203,203,203,203,203,203,203,203,203,203,203
203,203,203,123,124,203,203,203,203,203,203,203,203,203,203,203,203,203,124,203,5,5,203
203,203,124,122,123,124,124,123,124,124,123,124,124,124,123,124,124,124,123,124,123,5,203
203,203,124,121,122,122,121,122,121,121,121,122,122,121,121,123,122,123,124,124,124,203,203
203,203,124,122,121,123,124,123,123,124,124,124,123,123,123,123,124,5,5,123,123,203,203
203,203,124,121,124,123,123,123,203,203,203,203,5,124,5,203,203,203,5,124,124,203,203
203,203,123,121,124,123,203,203,203,203,203,203,5,124,5,203,203,203,123,122,123,203,203
203,203,124,121,123,123,203,203,203,203,203,5,120,5,203,203,203,203,124,121,123,203,203
203,203,123,121,124,203,203,203,203,203,203,119,119,5,203,203,203,203,123,122,123,203,203
203,203,124,121,123,123,203,203,203,203,120,119,120,203,203,203,203,203,124,122,124,203,203
203,203,123,121,121,123,203,5,203,119,119,120,120,203,203,203,203,5,124,121,123,203,203
203,203,124,124,121,124,5,5,119,120,119,119,120,203,203,203,5,124,123,122,124,203,203
203,203,5,123,121,123,124,124,119,119,120,120,120,203,203,5,124,5,124,122,124,203,203
203,203,5,123,121,124,5,5,119,203,203,120,120,120,120,119,5,203,124,121,123,203,203
203,203,5,124,121,123,203,203,203,203,203,120,120,119,119,5,203,203,123,122,124,203,203
203,203,5,123,121,123,203,203,203,203,203,120,119,5,120,203,203,203,124,121,123,203,203
203,203,124,121,121,123,203,203,203,203,203,120,119,119,203,203,203,203,5,122,124,123,203
203,203,123,122,122,123,203,203,203,203,119,119,119,120,203,203,203,203,5,121,122,124,203
203,203,123,121,121,123,203,203,203,5,5,120,120,203,203,203,203,203,123,124,124,123,203
203,203,123,121,123,203,203,203,203,119,119,5,203,203,203,203,203,123,123,123,123,124,203
203,203,124,121,123,203,203,203,5,120,119,203,203,203,203,203,203,123,123,123,122,123,203
203,203,123,122,123,203,203,203,5,124,5,203,203,203,203,203,123,123,123,124,121,123,203
203,203,123,122,123,123,203,5,124,5,203,203,203,203,203,123,123,123,123,123,124,203,203
203,203,123,123,121,124,123,124,124,124,123,5,123,123,123,123,123,123,123,122,124,203,203
203,5,5,123,124,121,121,122,121,122,122,123,121,124,124,123,124,122,123,123,5,5,203
203,5,5,5,123,123,123,124,123,124,124,123,123,124,123,124,123,123,5,5,5,5,5
203,5,5,5,203,203,203,203,203,203,203,203,203,203,203,203,203,203,203,203,5,5,5
203,203,203,203,203,203,203,203,203,203,203,203,203,203,203,203,203,203,203,203,203,5,5
12
12,8,0,104,104,0,7,7,8,1,0,Catapult
8,12,0,80,80,0,5,5,7,1,0,Catapult
20,10,0,104,104,0,7,7,7,1,0,Catapult
13,15,0,104,104,0,7,7,6,1,0,Catapult
2,15,3,100,30,0,30,10,3,1,0,Cavalry
16,2,3,60,0,35,5,25,2,1,0,Mage
17,2,0,100,30,0,30,10,2,1,0,Cavalry
2,14,0,60,0,35,5,25,3,1,0,Mage
8,20,3,60,0,35,5,25,4,1,0,Mage
9,20,0,100,30,0,30,10,4,1,0,Cavalry
25,6,3,100,30,0,30,10,1,1,0,Cavalry
25,7,0,60,0,35,5,25,1,1,0,Mage
10
22,15
21,16
20,17
19,18
7,5
6,5
5,6
5,7
5,5
19,17
