0
14,14
400,400,400,400,400,200,103,103,103,0,1,1,1,200
400,400,400,400,200,103,103,102,102,0,0,0,1,201
400,400,400,103,102,102,102,102,103,103,103,103,1,200
400,400,103,103,501,102,102,103,103,104,104,103,0,201
400,104,103,102,501,102,103,103,104,200,104,103,102,200
104,104,103,501,501,102,103,104,200,201,104,103,102,501
104,103,102,501,102,103,103,104,200,104,103,102,102,501
103,102,501,501,102,103,103,104,104,103,103,102,501,502
103,102,501,501,102,103,103,103,103,102,102,501,502,502
103,102,102,501,102,102,103,103,102,102,102,501,502,400
102,102,501,501,102,102,102,102,102,102,200,201,400,400
200,102,102,102,102,102,103,102,102,102,201,400,400,400
201,102,102,103,103,103,103,0,0,200,400,400,400,400
201,200,103,103,104,104,0,1,1,400,400,400,400,400
6
12,6,0,60,20,0,20,20,0,0,2,Archer
11,8,0,60,20,0,20,20,1,1,1,Archer
12,5,0,100,30,0,25,10,0,0,2,Cavalry
11,6,0,80,30,0,20,20,0,0,2,Swordsman
10,8,0,80,30,0,20,20,1,1,1,Swordsman
10,9,0,100,30,0,25,10,1,1,1,Cavalry
9
6,0
5,1
7,0
6,1
7,1
8,0
9,0
8,1
5,0
